wireless : sans fil
digital : numérique
to retranscribe : retranscrire
a wonder : une merveille
a marvel : une merveille
to switch : passer de
handwritten : manuscrit
without : sans
indeed : en effet
no need to : pas besoin de
to tap away : pianoter
typescript : tapuscrit

a transmitter : un transmetteur
to appear : apparaître
in real time : en temps réel
even better : encore mieux
anywhere : partout
instead of : au lieu de
a laptop : un ordinateur portable
at the top of : en haut de
to pick up : capter
to save : sauvegarder
once back home : une fois rentré à la maison
a content : un contenu
to store : archiver
to print : imprimer
to carry : transporter
fitted with : doté de
fitted with : équipé de
equipped with : doté de
equipped with : équipé de
ink : de l'encre
a cartridge : une cartouche
provided : fourni
included : fourni
internal : interne
memory : mémoire
which : qui
which : que
to deliver : livrer
Optical Character Recognition : Reconnaissance de Charactères
length : longueur