A trolley : un chariot, caddie
A leaflets: un prospectus
A stuff : un truc, un machin
A statement : une affirmation
Whole : entier, complet, intégral
A paper round : une tournée de livraison de journaux
To deliver : livrer
To be bored : s’ennuyer
Homeless : sans foyer, sans abris
A practice : une répétition
To earn money : gagner de l’argent
A string : une corde
To freeze/froze/frozen : gelé
Ink : de l’encre
A summary : un résumé
To depend on : dépendre de
To tick : cocher
A topic : un sujet
To dive : plonger
A lifeguard : un maître nageur 
Delivery : livraison
To be fed up with : en avoir assez de
To be bored : s’ennuyer, en avoir assez
To earn money : gagner de l’argent
To spend money : dépenser de l’argent
To waste money : gaspiller de l’argent
To save money : économiser de l’argent
Own : propre, à soi
To hire : louer
Trendy : à la mode, branché
Before : avant de
Main : principale
An amount : une somme, une quantitée
It doesn’t matter to me : cela m’importe peu, ça m’est égal
A goal : un but
An aim : un but
A purpose : un but
A downside : Un inconvénient
A disadvantage : Un inconvénient
A drawback : Un inconvénient 
Advice : des conseilles
Furniture : des meubles
A piece of : un
To perform : effectuer
Word Processor : traitement de texte
To hear/heard/heard : entendre
To leave/left/left : partir, quitter, laisser
To wonder : se demander
Still : encore, toujours
To move : bouger, déménager
Might : il se pourrait que
To hide/hid/hidden : se cacher
To breathe : respirer
Breath : la respiration
Until : jusqu’à
To rest : se reposer
To wake/wake/woken : se réveiller
To forget/forgot/forgotten : oublier
To sleep, slepe, slept : dormir
Rather : assez, plutôt
Deeply : profondément
A lie : un mensonge
To hide/hid/hidden : cacher, se cacher
Against : contre
No matter : peu importe
Somehow : quelque peu, en quelques sorte
A revenge : une vengeance, une revanche
To swear/swore/swon : jurer
A shadow : une ombre
To avoid : éviter
A loser : un perdant
To lose/lost/lost : perdre
To be aware : être conscient
T don’t care : je m’en fiche, je m’en moque
To seem : sembler, paraître
To hurt/hurt/hurt : blesser
Once again : encore une fois, une fois de plus
Too late : trop tard
To early : trop tôt
To forget/forgot/forgotten : oublier
To think/thought/thought : penser
To learn/learnt/learnt : apprendre
Already : déjà
A statement : une affirmation
To be interested in : être intéressé par
A course : un cours
To do a paper round : faire une tournée de livraison de journaux
To wast one’s time : gâcher son temps
To plan to : prévoire, projeter, planifier de
Bilingual : bilingue
To act : faire du théâtre, jouer la comédie
A skill : une compétence
An audience : un auditoire, publique
To invest : investir
Whole : entier, complet, intégral
An electrician : un électricien
Usual : habituel 
Unusual : inhabituel
A desk : un bureau
A fault : une panne
A firm : une entreprise
Several : plusieurs
It is the reason why : C’est la raison pour lequel
To be interested in : être intéressé par
To solve a problem : Résoudre un problème
A land : une terre
A pathway : un sentier
Ta back : le dos
The earth : la terre
Beneath : Sous, dessous, en-dessous
By : à côté de
To rely on : compter sur
Somewhere : quelque part
Something : quelque chose
Everything : tout
To fall/fell/fallen : tomber
Tired : fatigué
To walk : marcher
Empty : vide
Full : plein
Across : à travers
To feel/felt/felt : Sentir, ressentir
A caption : un titre, une légende
To use : utiliser
To teach/taught/taught : enseigner
To learn/learnt/learnt : apprendre
Such as : telle que
CAD (Computer Aided Design) : Conception Assisté par Ordinateur (CAO)
To design : Concevoir
A race : une course
Current : Actuelle, encours
An amount : une somme, une quantitée
To hold/held/held : détenir, posséder, tenir
A cash dispenser/machine : un distributeur de billet
To dispense : distribuer
Weather conditions : les conditions météos
A travel agency/agent : une agence de voyage/ un agent de voyage 
To find out about something : se renseigner sur quelque chose
Thanks to : grâce à
To display : afficher
LCD (Liquid Crystal Display) : Affichage à Cristaux Liquide
A flight : un vol
To switch on/off : allumer/éteindre
A microwave oven : un four à micro-ondes
Anything : n’importe quoi
To manage : gérer
A customer : un client
To print : imprimer
Even : même
A device : un appareil, un dispositif
A topix : un sujet
A schedule : un emploie du temps
A seamstress : une couturière
A suit : un costume
A tie : une cravate
A dress : une robe
A costume : un costume (déguisement)
Grown-up : adulte
Enought : asser
Fabric : du tissus
A pencil : un crayon
A statement : une affirmation
Ta be allowed : être autorisé
Tidy / Untidy : Rangé / Désordonné, mal rangé
Mesy : désordonné
Clean : Propre
Dirty : Sale
Early : tôt
Late : tard
A cedar : un cêtre
Asleep : endormi
A heap : un tas, un amas
A deadline : limite
To squeeze : serrer, presser, étreindre
A headline : un titre
To tidy : ranfer
A toy : un jouet
Salt : le sel
Salty : salé
A tear : une larme
A scent : une odeur, une senteur, un parfum
To linger : s’attarder, trainer
To draw/drew/drawn : tirer
A bank : une berge, une rive
To take a while : prendre son temps
Unholy : épouvantable, profane
A cloud : un nuage
Ta light/lit/lit : allumer
Above : au dessus
A storm chasser : un chasseur de tempêtes
Mainly : principalement
Spring/Summer/Autumn/Winter : Printemp/Eté/Automne/Hiver
Actually : en fait
Dust : la poussière
A hailstorm : une tempête de grêle
Lightning : les éclaires
Seasons : les saisons
Uncertainty : incertitude
To achieve : réaliser
Intinguing : fascinant
Scheming : intriguant
To get involved : se trouver impliqué
To notice : remarquer
To screw / To unscrew : visser / dévisser
A screwdriver : tournevis
A nut : un écrous
A hacksaw : une scie à métaux
To scrape : gratter
A gate : une barrière
A blade : une lame
A path : un chemin
A size : une taille
A shape : une forme
To tear : décliner
To fold / Unfold : Plier / Déplier
A seat : un siège
To stare at : regarder fixement / Fixer du regard
Will : la volonté
To reply : répondre
Numb : abasourdi
To disappoint : décevoir
Disappointment : la déception
Disappointed : déçus
Disappointing : déçevant
The chest : la poitrine
Application : candidature
To apply for : postuler/candidater/poser sa candidature
Able : Capable
Unable : Incapable
Nevertheless : Néanmoins
A novel : un roman
Darkness : obscurité
Softly : doucement
To creep-crept-crept : ramper
A seed : Une graine
A brain : un cerveau
To remain : rester
Within : au sein de
Restless : agiter
Alone : seul
Narrow : étroit
A cobblestone : un pavé
Beneath : sous, dessous, en-dessous
A street lamp : un réverbère, un lampadaire
A collar : un col (de chemise, veste)
Damp : humidité
To stab : poignarder
A Flash : un éclair, une lueur
To split-split-split : fendre / déchirer
Naked : nu
To share : partager
To dare : oser
To disturb : déranger
A fool : un imbécile/un idiot
A raindrop : une goutte de pluie
A well : un puit
To bow : se pencher/s’incliner
A warning : un avertissement
A tenement : un immeuble
To whisper : murmurer/chuchoter
Subway / Underground : Le métro
To seem : sembler / paraître
Anytime : A chaque fois 
Seisure : Le loisir, les temps libres
A wedding : Un mariage
Darm : Les fichus, les satanés
Roller Coaster : Les montagnes russes
Tired : Fatigué
Exhausted : Épuisé
To allot : Alloué / Dédié
Even : Même
Whopping : Énorme
A workload : Une charge de travail
A stumbling block : Un obstacle
Renowned : Renommé / Réputé
Shortage : Une pénurie
To incur : S’exposer à / S’attirer
Wrath : La colère
A lawn chair : Un chaise longue
Obvious : Evident
Obviously : Évidemment
To gossip : Faire des ragots / Faire des commérages
To top : Dépasser / Surclasser
To look like : ressembler (la vue)
To smell like : ressembler (l’odorat)
To taste like : ressembler (Le goût)
To sound like : ressembler (L’ouïe)
Cosy : Confortable
Household Management : La gestion du foyer
To yell : hurler
A chore : une corvée
To engage in : s’adonner à
Nagging : le harcèlement
To be involved : être impliquer
To depend : approfondir
Awesome : super/génial/extraordinaire/impressionnant
Intrusive : gênant/indiscret
A two-storey house : une maison à deux étages
At once : à la fois/ en même temps
To climb : escalader/ grimper 
Relationships : les relations
Instead/instead of : à la place / au lieu de
To reduce : rérduire
To reveal : révéler
Healthy : en bonne santée
Ability : capacity
Relatives : la famille, les proches
A gift : un cadeau
A joke : une blague
Magnificent : magnifique
A clue : un indice, une indication
Foolishness : la bêtise
To heal : guérir, cicatriser
A scar : une cicatrice
Whatever : tout ce qui / tout ce que
Womb : le ventre (de la mère enceinte)
Joyful : joyeux
To magnify : grossir (avec une loupe)/sublimer
A mark : une trace
A voice : une voix
A choice : un choix
Till/Untill : jusqu'à
To lift someone up : aider quelqu'un à se relever
Fat : la graisse / gros / gras
Fit : en forme, en bonne condition
To nibble : grignoter
To claim : prétendre
A crouch : un canapé
Appalling : épouvantable, consternant, navrant
Weight : le poids
To be overweight : être en surpoids
To lose weight : perdre du poids
To diet / to be on a diet : être au régime / faire un régime
Height : la hauteur, la taille
Expectation of life : l'espérence de vie
To be likely to : avoir de forte chances de
To complain : se plaindre
A garment : un vêtement
A purpose : un but
Numberless : innombrable
Although : bien que
A slimmer : une personne qui fait un régime
Thus : ainsi
To manage to : réussir à
To suffer from : souffrir de
A craze : un engouement
A disease : une maladie
Workshy : paresseux
A myth : un mythe
A survey : un sondage, une enquête
To squander : gaspiller
A grant : une bourse
A loan : un prêt, en emprunt
Earnings : les revenus, les gains, salaires
Consummer society : société de consommation
Misfit : inadapté
Significant : significatif
Abroad : à l'étranger
A bank account : un compte bancaire
According to : selon, d'après
Average : une moyenne / moyen, moyenne
Despite : en dépit de
To take steps : prendre des mesures
Earlier : plus tôt
Sooner : plus tôt
A school trip : un voyage scolaire
A career : une carrière
Worried : inquiet
Part-time : à temps partiel
Retirement : la retraite
One-third : un tier
Nearly : presque
To rule : gouverner, régner, dominer
To sweep-swept-swept : ballayer
To own : posséder
To roll the dice : lancer des dés
A croud : une foule
A castle : un château
A piller : un pilier
Salt : le sel
A sword : une épée
A shield : un bouclier
Once : une fois
Wiched : mauvais/méchant
Wild : sauvage
Silver : l'argent (le métal)
A puppet : une marionnette
A string : une ficelle
Sand : le sable
A sound : un son
To discover : découvrir
Fear : la peur
To feel-felt-felt : sentir/ressentir

Mots de liaisons:

Moreover, Furthermore : De plus
However : Toutefois, cependant
Yet : Pourtant
Anyway, Anyhow : De toute façon
Because of : A cause de
Thanks to : Grâce à
As a result, consequently, it is the reason why : En conséquence
So, therefore : Donc/Alors/Par conséquent
Given that, seeing that : Etant donné que
Fortunately : Heureusement
Unfortunately : Malheureusement
Indeed : En effet
At last : Enfin
in fact, as a matter of fact : En fait
Although : Bien que
Of course : Bien sûr
Thus : Ainsi
Since : Puisque
For : Car
As : Comme
First : Premièrement
Second : Deuxièmement
At first : En premier
Then : Ensuite
First of all : tout d’abord
Next : Ensuite
To make matters worse : Pour aggraver les choses
But the worst of all : Mais le pire de tout
On the one hand : D’un côté
On the other hand : De l’autre côté
On the face of it : De prime abord / À première vue
But on second thoughts : Mais, en y réfléchissant bien
To sum up / To put in a nutshell : Pour résumer / En bref
Whereas : Alors que
While : Pendant que
Even : Même
Even if : Même si
Despite, in spite of : En dépit de
Nevertheless, Nonetheless : Néanmoins 
On the contrary : Au contraire
Otherwise : Autrement
Unless : A condition Que
As long as : Du moment que
Except : Excepté, sauf
As if : Comme si
Provided : A condition que
Without : Sans
Almost, Nearly : Presque
After all : Après tout
For example : For instance: Par exemple
Instead, instead of : A la place / Au lieu de
As usual : Comme d’habitude